6

1.5 16.5 10.5 4.5
5
7.5 7.5 3.5 3.5 10.5
16.5 11.5 11.5 8.5 8.5
0 1 3 1 0 1

1.5 15.5 10.5 4.5
5
6.5 6.5 2.5 2.5 10.5
15.5 12.5 12.5 7.5 7.5
0 1 3 1 0 1

20.5 16.5 11.5 4.5
5
14.5 14.5 18.5 18.5 11.5
16.5 11.5 11.5 8.5 8.5
3 1 0 1 3 1 

20.5 15.5 11.5 4.5
5
15.5 15.5 19.5 19.5 11.5
15.5 12.5 12.5 7.5 7.5
3 1 0 1 3 1

10.5 18.5 10.5 4.5
4
10.5 7.5 7.5 10.5
15.5 15.5 11.5 11.5
1 3 1 0 1 

11.5 18.5 11.5 4.5
4
11.5 14.5 14.5 11.5
15.5 15.5 11.5 11.5
1 0 1 3 1
0 0 0 0 0 0 0 0 0 0 0 0 0 0 0 0 0 0 0 0 0 0 
0 0 0 0 0 0 0 0 0 0 0 0 0 0 0 0 0 0 0 0 0 0 
0 0 0 0 0 0 0 0 0 0 0 0 0 0 0 0 0 0 0 0 0 0 
0 0 0 0 0 0 0 0 0 0 0 0 0 0 0 0 0 0 0 0 0 0 
0 0 0 0 0 0 0 0 0 0 1 1 0 0 0 0 0 0 0 0 0 0 
0 0 0 0 0 0 0 0 0 0 1 1 0 0 0 0 0 0 0 0 0 0 
0 0 0 0 0 0 0 0 0 0 1 1 0 0 0 0 0 0 0 0 0 0 
0 0 1 1 1 1 1 1 1 1 1 1 1 1 1 1 1 1 1 1 0 0 
0 0 1 1 1 1 1 1 1 1 1 1 1 1 1 1 1 1 1 1 0 0 
0 0 1 1 0 0 0 0 0 0 1 1 0 0 0 0 0 0 1 1 0 0 
0 0 1 1 0 0 0 0 0 0 1 1 0 0 0 0 0 0 1 1 0 0 
0 0 1 1 1 1 1 1 1 1 1 1 1 1 1 1 1 1 1 1 0 0 
0 0 1 1 1 1 1 1 1 1 1 1 1 1 1 1 1 1 1 1 0 0 
0 0 0 0 0 0 1 1 0 0 0 0 0 0 1 1 0 0 0 0 0 0 
0 0 0 0 0 0 1 1 0 0 0 0 0 0 1 1 0 0 0 0 0 0  
0 1 1 1 1 1 1 1 1 1 1 1 1 1 1 1 1 1 1 1 1 0 
0 1 1 1 1 1 1 1 1 1 1 1 1 1 1 1 1 1 1 1 1 0 
0 0 0 0 0 0 0 0 0 0 1 1 0 0 0 0 0 0 0 0 0 0 
0 0 0 0 0 0 0 0 0 0 1 1 0 0 0 0 0 0 0 0 0 0 
0 0 0 0 0 0 0 0 0 0 0 0 0 0 0 0 0 0 0 0 0 0 
0 0 0 0 0 0 0 0 0 0 0 0 0 0 0 0 0 0 0 0 0 0

66
1 6
1 7
1 8
1 9
1 10
1 11
1 12
2 6
3 6
4 6
4 9
4 10
5 6
5 9 
5 10
6 6
6 9 
6 10
7 6
7 9
7 10
8 6
8 9
8 10
8 13
8 14
9 6
9 9
9 10
9 13
9 14
10 13
10 14
11 13
11 14
12 6
12 9
12 10
12 13
12 14
13 6
13 9
13 10
13 13
13 14
14 6
14 9
14 10
15 6
15 9
15 10
16 6
16 9
16 10
17 6
17 9
17 10
18 6
19 6
20 6
20 7
20 8
20 9
20 10
20 11
20 12
