//路径条数n
2
//路径1起点与终点坐标（x, y)所有路径终点应该是挨着的
1.5 15.5 18.5 3.5
//路径1转折点个数
5
//路径1的所有转折点x坐标（依次）
15.5 15.5 4.5 4.5 18.5
//路径1的所有转折点y坐标（依次）
15.5 12.5 12.5 6.5 6.5
//路径1的行进方向（0 右 1 下 2 上 3左）
0 1 3 1 0 1

//路径2 类似
//路径2起点与终点坐标
1.5 16.5 19.5 3.5
//转折点个数
5
16.5 16.5 5.5 5.5 19.5
16.5 11.5 11.5 7.5 7.5
0 1 3 1 0 1

//如有路径3 类似

//21*22的地图（1代表路径）左上为（0，0）代表地图中的左下角
0 0 0 0 0 0 0 0 0 0 0 0 0 0 0 0 0 0 0 0 0 0 
0 0 0 0 0 0 0 0 0 0 0 0 0 0 0 0 0 0 0 0 0 0 
0 0 0 0 0 0 0 0 0 0 0 0 0 0 0 0 0 0 0 0 0 0 
0 0 0 0 0 0 0 0 0 0 0 0 0 0 0 0 0 0 0 0 0 0 
0 0 0 0 0 0 0 0 0 0 0 0 0 0 0 0 0 0 1 1 0 0 
0 0 0 0 0 0 0 0 0 0 0 0 0 0 0 0 0 0 1 1 0 0 
0 0 0 0 1 1 1 1 1 1 1 1 1 1 1 1 1 1 1 1 0 0 
0 0 0 0 1 1 1 1 1 1 1 1 1 1 1 1 1 1 1 1 0 0 
0 0 0 0 1 1 0 0 0 0 0 0 0 0 0 0 0 0 0 0 0 0 
0 0 0 0 1 1 0 0 0 0 0 0 0 0 0 0 0 0 0 0 0 0 
0 0 0 0 1 1 0 0 0 0 0 0 0 0 0 0 0 0 0 0 0 0 
0 0 0 0 1 1 1 1 1 1 1 1 1 1 1 1 1 0 0 0 0 0 
0 0 0 0 1 1 1 1 1 1 1 1 1 1 1 1 1 0 0 0 0 0 
0 0 0 0 0 0 0 0 0 0 0 0 0 0 0 1 1 0 0 0 0 0 
0 0 0 0 0 0 0 0 0 0 0 0 0 0 0 1 1 0 0 0 0 0 
0 1 1 1 1 1 1 1 1 1 1 1 1 1 1 1 1 0 0 0 0 0 
0 1 1 1 1 1 1 1 1 1 1 1 1 1 1 1 1 0 0 0 0 0 
0 0 0 0 0 0 0 0 0 0 0 0 0 0 0 0 0 0 0 0 0 0 
0 0 0 0 0 0 0 0 0 0 0 0 0 0 0 0 0 0 0 0 0 0 
0 0 0 0 0 0 0 0 0 0 0 0 0 0 0 0 0 0 0 0 0 0 
0 0 0 0 0 0 0 0 0 0 0 0 0 0 0 0 0 0 0 0 0 0
//可以放塔的格子个数和坐标
71
2 5
2 6
2 7
2 8
2 9
2 10
2 11
2 12
3 5
3 6
3 7
3 8
3 9
3 10
3 11
3 12
4 5
5 5
6 5
7 5
8 5
9 5
10 5
11 5
12 5
13 5
14 5
15 5
16 5
17 5
6 8
6 9
7 8
7 9
8 8
8 9
9 8
9 9
10 8
10 9
11 8
11 9
12 8
12 9
13 8
13 9
14 8
14 9
15 8
15 9
16 8
16 9
17 8
17 9
18 8
18 9
19 8
19 9
20 8
20 9
6 10
7 10
8 10
9 10
10 10
17 10
17 11
17 12
20 5
20 6
20 7